NO texture/wall6.xpm

SO texture/wall7.xpm

WE texture/wall8.xpm

EA texture/wall9.xpm

C 109,150,205

F 31,52,47



        1111111111111111111111111
        1000000000110000000000001
        1011000001110000002000001
        1001000000000000000000001
111111111011000001110000000000001
100000000011000001110111111111111
11110111111111011100000010001
11110111111111011101010010201
11000000110101011100020010201
10002200000000001100000000001
10002200000000000001010010001
11000001110101011111011110N0111
11110111 1110101 101111010001
11111111 1111111 111111111111